5 5 0
12 7
#############
#### ########
#  E ########
# ####    ###
# #### ## ###
#      ######
#############